NO ./textures/north.xpm
SO ./textures/south.xpm
WE ./textures/west.xpm
EA ./textures/east.xpm

F 60,60,60
C 128,128,128

1111111111111
1000000000001
1000000000001
1000000000001
111111D111111
     101
     101
     101
     101
111111D111111
1000100010001
1000D000D0001
1000100010001
1111100011111
1000000000001
100000N000001
1111111111111
