NO ./textures/north.xpm
SO ./textures/south.xpm
WE ./textures/west.xpm
EA ./textures/east.xpm

F 60,60,60
C 128,128,128

11111111111
10000000001
10000000001
1000N000001
10000000001
10000000001
1000K000001
10000000001
10000000001
10000000001
11111111111
