NO ./textures/north.xpm
SO ./textures/north_copy.xpm
WE ./textures/north_copy_2.xpm
EA ./textures/north_copy_3.xpm

F 220,100,0
C 225,30,0

11111111111
10000000001
10000010011
1010N011111
10100110001
10000000001
10010011111
10010000001
10010000111
10000000111
11111111111
