NO ./textures/north.xpm
SO ./textures/north_copy.xpm
WE ./textures/north_copy_2.xpm
EA ./textures/north_copy_3.xpm

F 60,60,60
C 128,128,128

11111111111
10000000001
10000010001
1010N000001
10100110001
10000000001
10010011111
10010000001
10010000111
10000000001
11111111111
