NO ./textures/north.xpm
SO ./textures/south.xpm
WE ./textures/west.xpm
EA ./textures/east.xpm

F 60,60,60
C 128,128,128

11111111111
10000000001
10000010011
1010N011111
10100110001
10000000001
11110011111
10010000001
10010000111
10010000001
11111111111
